testproject
An Interactive Fiction by Julia Wychryst
Release 1 / Serial number 250903 / Inform 7 v10.1.2 / D

Library
A room full of books meant to expand one's knowledge. A hidden door lies to the north. A downstairs hallway lies to the west.

You can see Ledger here.

>hop
You jump on the spot.

>s
You can't go that way.

>w
You can't go that way.

>n
You can't go that way.

>e
You can't go that way.

* * *

testproject
An Interactive Fiction by Julia Wychryst
Release 1 / Serial number 250903 / Inform 7 v10.1.2 / D

Library
A room full of books meant to expand one's knowledge. A hidden door lies to the north. A downstairs hallway lies to the west.

You can see Ledger here.

>n
Bookcase Door
You find a door that leads to the kitchen, though why the two connect you aren't sure.

>n
Kitchen
A lovely kitchen filled with windows, allowing for a grand view of the estate's gardens.

You can see Chef Hat here.

>wear chef hat
(first taking Chef Hat)
You put on Chef Hat.

* * *

testproject
An Interactive Fiction by Julia Wychryst
Release 1 / Serial number 250903 / Inform 7 v10.1.2 / D

Library
A room full of books meant to expand one's knowledge. A hidden door lies to the north. A downstairs hallway lies to the west.

You can see Ledger here.

>read ledger
You see nothing special about Ledger.

>n
Bookcase Door
You find a door that leads to the kitchen, though why the two connect you aren't sure.

* * *

>n
Kitchen
A lovely kitchen filled with windows, allowing for a grand view of the estate's gardens.

You can see Chef Hat here.

>wear chef hat
(first taking Chef Hat)
You can't wear that!

* * *

testproject
An Interactive Fiction by Julia Wychryst
Release 1 / Serial number 250903 / Inform 7 v10.1.2 / D

Library
A room full of books meant to expand one's knowledge. A hidden door lies to the north. A downstairs hallway lies to the west.

You can see Ledger here.

>s
You can't go that way.

>w
Downstairs Hallway
The space that connects the many rooms of the house to each other.

You can see Shelf (on which is Vase (in which is Key)) here.

>n
Grand Staircase
You can only go up from here.

>w
You can't go that way.

>e
You can't go that way.

>s
Downstairs Hallway
The space that connects the many rooms of the house to each other.

You can see Shelf (on which is Vase (in which is Key)) here.

>w
Guest Bedroom
The room your gracious hosts gave to you for your trip. Even though it's a guest room, it could be the master of any average home.

>n
Guest Bathroom
The spacious bathroom attached to your bedroom, complete with a towel warmer.

You can see Medicine Cabinet (in which is Pill Bottle) here.

* * *

>w
Downstairs Hallway
The space that connects the many rooms of the house to each other.

You can see Shelf (on which is Vase (in which is Key)) here.

>w
Guest Bedroom
The room your gracious hosts gave to you for your trip. Even though it's a guest room, it could be the master of any average home.

>e
Hallway
The space that connects the library to the main entrance.

>s
Entrance
The grand entrance to the not-so-humble abode you've been invited to stay in for the duration of your holiday.

* * *

testproject
An Interactive Fiction by Julia Wychryst
Release 1 / Serial number 250903 / Inform 7 v10.1.2 / D

Library
A room full of books meant to expand one's knowledge. A hidden door lies to the north. A downstairs hallway lies to the west.

You can see Ledger here.

>w
Downstairs Hallway
The space that connects the many rooms of the house to each other. The entrance to the estate lies south. The grand staircase lies north. The guest bedroom lies west.

You can see Shelf here.

>n
Grand Staircase
You can only go up from here.

>n
Upstairs Hallway
You find that you can only go left off of the stairs, pondering the reason for such a grand staircase.

>s
Grand Staircase
You can only go up from here.

>s
Downstairs Hallway
The space that connects the many rooms of the house to each other.

>w
Guest Bedroom
The room your gracious hosts gave to you for your trip. Even though it's a guest room, it could be the master of any average home.

>n
Guest Bathroom
The spacious bathroom attached to your bedroom, complete with a towel warmer.

* * *

>w
Downstairs Hallway
The space that connects the many rooms of the house to each other. The entrance to the estate lies south. The grand staircase lies north. The guest bedroom lies west.

You can see Shelf here.

>s
Entrance
The grand entrance to the not-so-humble abode you've been invited to stay in for the duration of your holiday.

* * *

>w
Downstairs Hallway
The space that connects the many rooms of the house to each other. The entrance to the estate lies south. The grand staircase lies north. The guest bedroom lies west.

You can see Shelf here.

>w
Guest Bedroom
The room your gracious hosts gave to you for your trip. Even though it's a guest room, it could be the master of any average home.

>w
You can't go that way.

>n
Guest Bathroom
The spacious bathroom attached to your bedroom, complete with a towel warmer.

You can see Medicine Cabinet (in which is Pill Bottle) here.

>take pill bottle
Taken.

* * *

>w
Downstairs Hallway
The space that connects the many rooms of the house to each other. The entrance to the estate lies south. The grand staircase lies north. The guest bedroom lies west.

You can see Shelf here.

>x room
You can't see any such thing.

>x downstairs hallway
You can't see any such thing.

>l
Downstairs Hallway
The space that connects the many rooms of the house to each other. The entrance to the estate lies south. The grand staircase lies north. The guest bedroom lies west.

You can see Shelf here.

>x shelf
You see a vase sitting on the shelf, it's a little dusty.

>x vase
You hear a faint rattling inside the vase and pour it into your hand. A key falls out.

>take key
Taken.

>w
Guest Bedroom
The room your gracious hosts gave to you for your trip. Even though it's a guest room, it could be the master of any average home. The guest bathroom lies north.

>n
Guest Bathroom
The spacious bathroom attached to your bedroom, complete with a towel warmer.

You can see Medicine Cabinet here.

>x medicine cabinet
Looking at it won't help you.

>open medicine cabinet
You find an empty pill bottle that isn't yours. It's perscribed to one of your hosts.

>x pill bottle
The label suggests that this medicine was used for helping high blood pressure.

>x key
It looks rather old, layers of rust anf grime cover the key.

* * *

>w
Downstairs Hallway
The space that connects the many rooms of the house to each other. The entrance to the estate lies south. The grand staircase lies north. The guest bedroom lies west.

You can see Shelf here.

>x vase
You hear a faint rattling inside the vase and pour it into your hand. A key falls out.

* * *

>take key
Taken.

>w
Guest Bedroom
The room your gracious hosts gave to you for your trip. Even though it's a guest room, it could be the master of any average home.

>n
Guest Bathroom
The spacious bathroom attached to your bedroom, complete with a towel warmer.

You can see Medicine Cabinet here.

>open medicine cabinet
You find an empty pill bottle that isn't yours. It's perscribed to one of your hosts.

* * *

testproject
An Interactive Fiction by Julia Wychryst
Release 1 / Serial number 250903 / Inform 7 v10.1.2 / D

Library
A room full of books meant to expand one's knowledge. A hidden door lies to the north. A downstairs hallway lies to the west.

You can see Ledger here.

>x ledger
It seems to have pages missing.

>n
Bookcase Door
You find a door that leads to the kitchen, though why the two connect you aren't sure.

* * *

>n
Kitchen
A lovely kitchen filled with windows, allowing for a grand view of the estate's gardens.

You can see Chef Hat here.

>wear chef hat
(first taking Chef Hat)
It's a little big for your head.