Spuddy Rescue
An Interactive Fiction by Julia Wychryst
Release 1 / Serial number 251001 / Inform 7 v10.1.2 / D

Parking Lot
 You stand outside the grounds of Tuber County's Fall Fair. While you had a great time eating snacks and playing games, you realize your trusty pets, affectionately referred to as spuddies, got lost in all the excitement. You're near your car, but you know you can't leave until all of your spuddies are found. Better start looking for Robert, Bean, and Peggy! The entrance to the fair grounds lies to the north. The exit to the parking lot lies south. 

You can see Car (closed) here.

>n
Fairgrounds Entrance
The entrance to the annual fair, it's a much larger than you remembered it. The food stands are to the north. The fair games are to the west. The rides are to the east. The parking lot lies south.

>n
Food Stands
The smell of fennel cake permeates the air, a classic scent from the fair. Other than the fennel cake stall, you see a stall for dirt burgers. The fairgrounds entrance lies to the south.

You can see Fennel Cake Stall and Dirt Burger Stall here.

>s
Fairgrounds Entrance
The entrance to the annual fair, it's a much larger than you remembered it. The food stands are to the north. The fair games are to the west. The rides are to the east.

>w
Fair Games
The games bring back memories of visiting the fair as a young tot. The barrel roll used to be your favorite.  Funnily enough, you hear a noise coming from one of the barrels.

>e
Fairgrounds Entrance
The entrance to the annual fair, it's a much larger than you remembered it. The food stands are to the north. The fair games are to the west. The rides are to the east.

>w
Fair Games
The games bring back memories of visiting the fair as a young tot. The barrel roll used to be your favorite.

* * *

>n
Food Stands
The smell of fennel cake permeates the air, a classic scent from the fair. Other than the fennel cake stall, you see a stall for dirt burgers. The fairgrounds entrance lies to the south.

You can see Fennel Cake Stall and Dirt Burger Stall here.

>x dirt box
You see the top of a spuddy's head. From what you can tell, it looks like Bean.

>x dirt burger stall
Not the most appetizing food at the fair, but it's a staple.  You notice a box of dirt to the side of the stall, something seems to be moving inside.

>x box of dirt
You see the top of a spuddy's head. From what you can tell, it looks like Bean.

* * *

>n
Fairgrounds Entrance
The entrance to the annual fair, it's a much larger than you remembered it. The food stands are to the north. The fair games are to the west. The rides are to the east. The parking lot lies south.

>w
Fair Games
The games bring back memories of visiting the fair as a young tot. The barrel roll used to be your favorite. The fairgrounds entrance lies to the east. The bingo tent lies to the north.  Funnily enough, you hear a noise coming from one of the barrels.

You can see Barrel (closed) here.

>n
Bingo Tent
You return to the tent in which you lost a fair share of money. It's your favorite spot of the entire fair, so much so that the volunteers recognize you. The fair games are south.

You can see Table (on which is Bingo Card) here.

>x bingo card
You see an abandoned bingo card lying on the table. You take a quick glance around the tent to see if the card's owner is near. You don't see anyone near this card. Do you play?  So much money spent at the tent.

>x bingo card
Against your better judgement, you decide to play the abandoned card. After all, it's free to you. Lucky for you, the new round just started.  The numbers haunt you in your sleep.

>x bingo card
The bingo caller starts rattling off numbers. To your surprise, all of the numbers called are on your card.  So much money spent at the tent.

>x bingo card
As more numbers are called, you start to sweat in anticipation of winning. You're only one number from bingo. It's a race to the finish between yourself and the old broads that stalk the tent.  It's a good thing this fair only happens once a year.

>x bingo card
The caller shouts the next number, one that isn't on your card. To your horror, one of the broads shouts "BINGO!" at the top of her shriveled lungs. Your head smacks the table as you slouch forward in defeat.  You can't be trusted at the bingo tent.

>x bingo card
The numbers haunt you in your sleep.

>x table
The same plastic tables they've been using for years. They look more disgusting each time you see them. Maybe they'll buy new tables for the next fair.

>x card
Maybe you should try a different game at the fair.

>l
Bingo Tent
You return to the tent in which you lost a fair share of money. It's your favorite spot of the entire fair, so much so that the volunteers recognize you. The fair games are south.

You can see Bingo Card and Table here.

>x card
You can't be trusted at the bingo tent.

>x table
The same plastic tables they've been using for years. They look more disgusting each time you see them. Maybe they'll buy new tables for the next fair.

>s
Fair Games
The games bring back memories of visiting the fair as a young tot. The barrel roll used to be your favorite. The fairgrounds entrance lies to the east. The bingo tent lies to the north. 

You can see Barrel (closed) here.

>e
Fairgrounds Entrance
The entrance to the annual fair, it's a much larger than you remembered it. The food stands are to the north. The fair games are to the west. The rides are to the east. The parking lot lies south.

>n
Food Stands
The smell of fennel cake permeates the air, a classic scent from the fair. Other than the fennel cake stall, you see a stall for dirt burgers. The fairgrounds entrance lies to the south.

You can see Fennel Cake Stall, Counter (on which is Fennel Cake Sample), Seed Burger Stall and a Box of Dirt (in which is a pile of dirt) here.

>x fennel cake stall
You wish you could buy a fennel cake for the road, but you ran out of money at the bingo tent. While you can't buy a fennel cake, you see the counter has samples for tasting.

>x counter
On Counter is Fennel Cake Sample.

>x sample
The best fair food you've ever tasted. It's a delicacy. No matter how many times you try to make it at home, it never tastes the same.

>take sample
Taken.

>eat sample
You wish you could have more of this delectable treat, but there's a sign that says "Limit of One Sample Per Person".

* * *

>w
Fair Games
The games bring back memories of visiting the fair as a young tot. The barrel roll used to be your favorite. The fairgrounds entrance lies to the east. The bingo tent lies to the north.  Funnily enough, you hear a noise coming from one of the barrels.

You can see Barrel (closed) here.

>x barrel
You recognize the noises coming from the barrel; they belong to Robert! While you don't know how he got inside the barrel, you ponder about ways to get him out. Maybe there's a tool somewhere?  You see Robert in the barrel.

>l
Fair Games
The games bring back memories of visiting the fair as a young tot. The barrel roll used to be your favorite. The fairgrounds entrance lies to the east. The bingo tent lies to the north. 

You can see Barrel (closed) here.

>e
Fairgrounds Entrance
The entrance to the annual fair, it's a much larger than you remembered it. The food stands are to the north. The fair games are to the west. The rides are to the east. The parking lot lies south.

>e
Rides
There are less rides at this year's fair, really the only functioning attraction is the barrel spin. Some haystacks sit behind the barrel spin. The fairgrounds entrance lies to the west.  You think you see something around one of the haystacks.

You can see a Crowbar and Haystacks here.

>take crowbar
Taken.

>search haystacks
You find nothing of interest.

>x haystacks
You stare at the haystacks, debating whether or not you should dig through them.  Who could possibly need this much hay?

>look in haystacks
You find nothing of interest.

>x haystacks
You determine the stack you want to dive into, hoping to find your lost spuddy. Money for a fennel cake would work too.  They could've had a hay ride with all of this hay.

>x hyastacks
You can't see any such thing.

>x haystacks
At the very bottom of the stack, you find Peggy.  You'll be finding hay in random places for weeks to come.

>take peggy
Taken.

>i
You are carrying:
  Peggy
  a Crowbar
  Hatchback Keys

>l
Rides
There are less rides at this year's fair, really the only functioning attraction is the barrel spin. Some haystacks sit behind the barrel spin. The fairgrounds entrance lies to the west. 

You can see Haystacks here.

>w
Fairgrounds Entrance
The entrance to the annual fair, it's a much larger than you remembered it. The food stands are to the north. The fair games are to the west. The rides are to the east. The parking lot lies south.

>n
Food Stands
The smell of fennel cake permeates the air, a classic scent from the fair. Other than the fennel cake stall, you see a stall for dirt burgers. The fairgrounds entrance lies to the south.

You can see Fennel Cake Stall, Seed Burger Stall and a Box of Dirt (in which is a pile of dirt) here.

>x box of dirt
It's a box  full of dirt. It's possible that something else might be deeper in the dirt .

In the Box of Dirt is a pile of dirt.

>search pile of dirt
Buried beneath the dirt, you find one of your missing spuddies.

>take spuddy
Taken.

>x spuddy
Bean! Your loyal spuddy who, while in her old age, still manages to have bursts of energy.

>x seed burger stall
Not the most appetizing food at the fair, but it's a staple.  You notice a box of dirt to the side of the stall, something seems to be moving inside.

>x fennel cake stall
You wish you could buy a fennel cake for the road, but you ran out of money at the bingo tent.

>l
Food Stands
The smell of fennel cake permeates the air, a classic scent from the fair. Other than the fennel cake stall, you see a stall for dirt burgers. The fairgrounds entrance lies to the south.

You can see Fennel Cake Stall, Seed Burger Stall and a Box of Dirt (in which is a pile of dirt) here.

>s
Fairgrounds Entrance
The entrance to the annual fair, it's a much larger than you remembered it. The food stands are to the north. The fair games are to the west. The rides are to the east. The parking lot lies south.

>w
Fair Games
The games bring back memories of visiting the fair as a young tot. The barrel roll used to be your favorite. The fairgrounds entrance lies to the east. The bingo tent lies to the north. 

You can see Barrel (closed) here.

>x barrel
You see Robert in the barrel.

>open barrel
It seems to be locked.

>open barrel with crowbar
You manage to break open the barrel, freeing Robert from his confinement. He leaps toward you and circles your feet, happy to be back with his owner. You watch as Robert runs back towards the entrance, presumably heading to your car.

>take robert
I don't suppose Robert would care for that.

>n
Bingo Tent
You return to the tent in which you lost a fair share of money. It's your favorite spot of the entire fair, so much so that the volunteers recognize you.

>s
Fair Games
The games bring back memories of visiting the fair as a young tot. The barrel roll used to be your favorite. The fairgrounds entrance lies to the east. The bingo tent lies to the north. 

You can see Robert here.

I beg your pardon?

>e
Fairgrounds Entrance
The entrance to the annual fair, it's a much larger than you remembered it. The food stands are to the north. The fair games are to the west. The rides are to the east. The parking lot lies south.

>s
Parking Lot
 The parking lot is less busy than it was when you arrived; you've been here for hours. The entrance to the fair grounds lies to the north. The exit to the parking lot lies south.

You can see Car (closed) here.

>open car
It seems to be locked.

>i
You are carrying:
  a spuddy
  Peggy
  a Crowbar
  Hatchback Keys

>open car with keys
You unlock Car.

>enter car
You can't get into the closed Car.

>deposit spuddy in car
That's not a verb I recognise.

>place spuddy in car
That's not a verb I recognise.

>put spuddy in car
Car is closed.

>open car
You open Car.

>put spuddy in car
You put the spuddy into Car.

>put peggy in car
You put Peggy into Car.

>put robert in car
You can't see any such thing.

>l
Parking Lot
 The parking lot is less busy than it was when you arrived; you've been here for hours. The entrance to the fair grounds lies to the north. The exit to the parking lot lies south.

You can see Car (in which are Peggy and a spuddy) here.

>n
Fairgrounds Entrance
The entrance to the annual fair, it's a much larger than you remembered it. The food stands are to the north. The fair games are to the west. The rides are to the east. The parking lot lies south.

>e
Rides
There are less rides at this year's fair, really the only functioning attraction is the barrel spin. Some haystacks sit behind the barrel spin. The fairgrounds entrance lies to the west. 

You can see Haystacks here.

>w
Fairgrounds Entrance
The entrance to the annual fair, it's a much larger than you remembered it. The food stands are to the north. The fair games are to the west. The rides are to the east. The parking lot lies south.

>w
Fair Games
The games bring back memories of visiting the fair as a young tot. The barrel roll used to be your favorite. The fairgrounds entrance lies to the east. The bingo tent lies to the north. 

You can see Robert here.

>speak to robert
I didn't understand that sentence.

>talk to robert
That's not a verb I recognise.

>bring robert
That's not a verb I recognise.

>e
Fairgrounds Entrance
The entrance to the annual fair, it's a much larger than you remembered it. The food stands are to the north. The fair games are to the west. The rides are to the east. The parking lot lies south.

>s
Parking Lot
 The parking lot is less busy than it was when you arrived; you've been here for hours. The entrance to the fair grounds lies to the north. The exit to the parking lot lies south.

You can see Car (in which are Peggy and a spuddy) here.

>enter car
You get into Car.

In Car you can see Peggy and a spuddy.

>drive car
That's not a verb I recognise.

>l
Parking Lot (in Car)
 The parking lot is less busy than it was when you arrived; you've been here for hours. The entrance to the fair grounds lies to the north. The exit to the parking lot lies south.

In Car you can see Peggy and a spuddy.

>s
*** After spending hours at the fair, you can finally leave with all of your spuddies back in your care. With a glance back to the fair, you drive off and head home. ***

Would you like to RESTART, RESTORE a saved game, QUIT or UNDO the last command?

* * *

>open car
(Car Keys)
It isn't something you can open.

>i
You are carrying:
  Car Keys

>unlock car
(Car Keys with Car Keys)
That doesn't seem to be something you can unlock.

>open car
(Car Keys)
It isn't something you can open.

>use car keys
That's not a verb I recognise.

>unlock car
(Car Keys with Car Keys)
That doesn't seem to be something you can unlock.

>unlock car with car keys
(Car Keys with Car Keys)
That doesn't seem to be something you can unlock.

>n
Fairgrounds Entrance
The entrance to the annual fair, it's a much larger than you remembered it. The food stands are to the north. The fair games are to the west. The rides are to the east.

>e
Rides
There are less rides at this year's fair, really the only functioning attraction is the barrel spin. Some haystacks sit behind the barrel spin. The fairgrounds entrance lies to the east.  You think you see something around one of the haystacks.

You can see Crowbar here.

>take crowbar
Taken.

>s
You can't go that way.

>w
Fairgrounds Entrance
The entrance to the annual fair, it's a much larger than you remembered it. The food stands are to the north. The fair games are to the west. The rides are to the east.

>w
Fair Games
The games bring back memories of visiting the fair as a young tot. The barrel roll used to be your favorite. The fairgrounds entrance lies to the west.  Funnily enough, you hear a noise coming from one of the barrels.

You can see Barrel (closed) here.

>x barrel
You recognize the noises coming from the barrel; they belong to Robert! While you don't know how he got inside the barrel, you ponder about ways to get him out. Maybe there's a tool somewhere?  You see Robert in the barrel.

>unlock barrel
What do you want to unlock Barrel with?

>unlock barrel with crowbar
You unlock Barrel.

>x robert
You can't see any such thing.

>x barrel
You see Robert in the barrel.

>take robert
You can't see any such thing.

>i
You are carrying:
  Crowbar
  Car Keys

>x self
As good-looking as ever.

>l
Fair Games
The games bring back memories of visiting the fair as a young tot. The barrel roll used to be your favorite. The fairgrounds entrance lies to the west. 

You can see Barrel (closed) here.

>w
You can't go that way.

>e
Fairgrounds Entrance
The entrance to the annual fair, it's a much larger than you remembered it. The food stands are to the north. The fair games are to the west. The rides are to the east.

>n
Food Stands
The smell of fennel cake permeates the air, a classic scent from the fair. Other than the fennel cake stall, you see a stall for dirt burgers. The fairgrounds entrance lies to the south.

You can see Fennel Cake Stall and Dirt Burger Stall here.

>x fennel cake stall
You wish you could buy a fennel cake for the road, but you ran out of money in the bingo tent.

>x dirt burger stall
Not the most appetizing food at the fair, but it's a staple. You notice a box of dirt to the side of the stall, something seems to be moving inside.

>x dirt box
I only understood you as far as wanting to examine Dirt Burger Stall.

* * *

>s
You want to leave without your spuddies? That's reckless abandonment, friend.

>s
You want to leave without your spuddies? That's reckless abandonment, friend.

>yes
That was a rhetorical question.

* * *

>x car
You need to open the door if you want to put anything inside.

>Open car door
I only understood you as far as wanting to open Car.

>open car door
I only understood you as far as wanting to open Car.

>open car
It isn't something you can open.

* * *

>x car
You need to open the door if you want to put anything inside.

>n
Fairgrounds Entrance
The entrance to the annual fair, it's a much larger than you remembered it. The food stands are to the north. The fair games are to the west. The rides are to the east. The parking lot lies south.

>n
Food Stands
The smell of fennel cake permeates the air, a classic scent from the fair. Other than the fennel cake stall, you see a stall for dirt burgers. The fairgrounds entrance lies to the south.

You can see Fennel Cake Stall, Seed Burger Stall and a Box of Dirt (in which is a pile of dirt) here.

* * *

>x box of dirt
It's a box  full of dirt. It's possible that something else might be deeper in the dirt .

In the Box of Dirt is a pile of dirt.

>x dirt
(the Box of Dirt)
It's a box .

In the Box of Dirt is a pile of dirt.

>x pile of dirt
A heap of nutrient-rich dirt.

>look in dirt
(the Box of Dirt)
In the Box of Dirt is a pile of dirt.

>look in pile of dirt
You find nothing of interest.

>search pile of dirt
You find nothing of interest.

>x pile of dirt
A heap of nutrient-rich dirt.

>x dit
You can't see any such thing.

>x dirt
(the Box of Dirt)
It's a box .

In the Box of Dirt is a pile of dirt.

>look in dirt
(the Box of Dirt)
In the Box of Dirt is a pile of dirt.

* * *

>look in pile of dirt
You find nothing of interest.

>x box of dirt
It's a box .

In the Box of Dirt is a pile of dirt.

>x pile of dirt
A heap of nutrient-rich dirt.

>look in pile of dirt
You find nothing of interest.

>search dirt
(the Box of Dirt)
In the Box of Dirt is a pile of dirt.

>x dirt
(the Box of Dirt)
It's a box .

In the Box of Dirt is a pile of dirt.

>search dirt
(the Box of Dirt)
In the Box of Dirt is a pile of dirt.

>take dirt
(the Box of Dirt)
You don't have the means to carry dirt. Why would you want to?

>x dirt
(the Box of Dirt)
It's a box .

In the Box of Dirt is a pile of dirt.

* * *

>search pile of dirt
You find nothing of interest.

>l
Food Stands
The smell of fennel cake permeates the air, a classic scent from the fair. Other than the fennel cake stall, you see a stall for dirt burgers. The fairgrounds entrance lies to the south.

You can see Fennel Cake Stall, Seed Burger Stall and a Box of Dirt (in which is a pile of dirt) here.

* * *

>s
Fairgrounds Entrance
The entrance to the annual fair, it's a much larger than you remembered it. The food stands are to the north. The fair games are to the west. The rides are to the east. The parking lot lies south.

>e
Rides
There are less rides at this year's fair, really the only functioning attraction is the barrel spin. Some haystacks sit behind the barrel spin. The fairgrounds entrance lies to the west.  You think you see something around one of the haystacks.

You can see a Crowbar and Haystacks here.

>x crobar
You can't see any such thing.

>x crowbar
A stray crowbar lies next to a booth.  It might be useful for something.

>take crowbar
Taken.

>x haystacks
You stare at the haystacks, debating whether or not you should dig through them.  Who could possibly need this much hay?

>x haystacks
You determine the stack you want to dive into, hoping to find your lost spuddy. Money for a fennel cake would work too.  They could've had a hay ride with all of this hay.

>x haystacks
At the very bottom of the stack, you find Peggy.  You'll be finding hay in random places for weeks to come.

* * *

>take peggy
Taken.

>x hay
That's a lot of hay.

>i
You are carrying:
  Peggy
  a Crowbar
  Car Keys

>w
Fairgrounds Entrance
The entrance to the annual fair, it's a much larger than you remembered it. The food stands are to the north. The fair games are to the west. The rides are to the east. The parking lot lies south.

* * *

>n
Food Stands
The smell of fennel cake permeates the air, a classic scent from the fair. Other than the fennel cake stall, you see a stall for dirt burgers. The fairgrounds entrance lies to the south.

You can see Fennel Cake Stall, Seed Burger Stall and a Box of Dirt (in which is a pile of dirt) here.

>s
Fairgrounds Entrance
The entrance to the annual fair, it's a much larger than you remembered it. The food stands are to the north. The fair games are to the west. The rides are to the east. The parking lot lies south.

>w
Fair Games
The games bring back memories of visiting the fair as a young tot. The barrel roll used to be your favorite. The fairgrounds entrance lies to the east.  Funnily enough, you hear a noise coming from one of the barrels.

You can see Barrel (closed) here.

>x barrel
You recognize the noises coming from the barrel; they belong to Robert! While you don't know how he got inside the barrel, you ponder about ways to get him out. Maybe there's a tool somewhere?  You see Robert in the barrel.

>open barrel with crowbar
You manage to break open the barrel, freeing Robert from his confinement. He leaps toward you and circles your feet, happy to be back with his owner. You watch as Robert runs back towards the entrance, presumably heading to your car.

* * *

>take robert
I don't suppose Robert would care for that.

>e
Fairgrounds Entrance
The entrance to the annual fair, it's a much larger than you remembered it. The food stands are to the north. The fair games are to the west. The rides are to the east. The parking lot lies south.

>s
Parking Lot
 The parking lot is less busy than it was when you arrived; you've been here for hours.The entrance to the fair grounds lies to the north. The exit to the parking lot lies south.

You can see Car (closed) here.

>unlock car
What do you want to unlock Car with?

>unlock car with car keys
(Car with Car Keys)
You unlock Car.

>put peggy in car
(Car Keys)
That can't contain things.

>s
Exit

* * *

>x car
You need to open the door if you want to put anything inside.

>open car
It seems to be locked.

>unlock car
(with Hatchback Keys)
You unlock Car.

>n
Fairgrounds Entrance
The entrance to the annual fair, it's a much larger than you remembered it. The food stands are to the north. The fair games are to the west. The rides are to the east. The parking lot lies south.

You can see Balloon Cart (in which is Balloon Animal) here.

>x cart
The trusty balloon cart returned for this year's fair. Each person receives a complimentary balloon animal upon entry, but you were given one earlier.  Unfortunately, you lost it when your spuddies ran away. You could take another, it's not like there's a volunteer currently manning the cart.

>x balloon animal
The balloon animal calls to you, wanting to be free of its restraints to the cart. No, it can't actually speak, but you're trying to convince yourself to take the little guy. Maybe you could give it a name.

>take balloon animal
Taken.

>i
You are carrying:
  Balloon Animal
  Hatchback Keys

>n
Food Stands
The smell of fennel cake permeates the air, a classic scent from the fair. Other than the fennel cake stall, you see a stall for dirt burgers. The fairgrounds entrance lies to the south.

You can see Fennel Cake Stall, Counter (on which is Fennel Cake Sample), Seed Burger Stall and a Box of Dirt (in which is a pile of dirt) here.

>s
Fairgrounds Entrance
The entrance to the annual fair, it's a much larger than you remembered it. The food stands are to the north. The fair games are to the west. The rides are to the east. The parking lot lies south.

You can see Balloon Cart (empty) here.

>w
Fair Games
The games bring back memories of visiting the fair as a young tot. The barrel roll used to be your favorite. The fairgrounds entrance lies to the east. The bingo tent lies to the north.  Funnily enough, you hear a noise coming from one of the barrels.

You can see Barrel (closed) here.

* * *

>n
Bingo Tent
You return to the tent in which you lost a fair share of money. It's your favorite spot of the entire fair, so much so that the volunteers recognize you. The fair games are south.

You can see Table (on which is Bingo Card) here.

>s
Fair Games
The games bring back memories of visiting the fair as a young tot. The barrel roll used to be your favorite. The fairgrounds entrance lies to the east. The bingo tent lies to the north. 

You can see Barrel (closed) here.

>e
Fairgrounds Entrance
The entrance to the annual fair, it's a much larger than you remembered it. The food stands are to the north. The fair games are to the west. The rides are to the east. The parking lot lies south.

You can see Balloon Cart (empty) here.

>e
Rides
There are less rides at this year's fair, really the only functioning attraction is the barrel spin. Some haystacks sit behind the barrel spin. The fairgrounds entrance lies to the west.  You think you see something around one of the haystacks.

You can see a Crowbar and Haystacks here.

>w
Fairgrounds Entrance
The entrance to the annual fair, it's a much larger than you remembered it. The food stands are to the north. The fair games are to the west. The rides are to the east. The parking lot lies south.

You can see Balloon Cart (empty) here.

>s
Parking Lot
 The parking lot is less busy than it was when you arrived; you've been here for hours. The entrance to the fair grounds lies to the north. The exit to the parking lot lies south.

You can see Car (closed) here.

>s
You want to leave without your spuddies? That's reckless abandonment, friend.

>n
Fairgrounds Entrance
The entrance to the annual fair, it's a much larger than you remembered it. The food stands are to the north. The fair games are to the west. The rides are to the east. The parking lot lies south.

You can see Balloon Cart (empty) here.

>e
Rides
There are less rides at this year's fair, really the only functioning attraction is the barrel spin. Some haystacks sit behind the barrel spin. The fairgrounds entrance lies to the west. 

You can see a Crowbar and Haystacks here.

>m
That's not a verb I recognise.

>n
You can't go that way.

>e
You can't go that way.

>w
Fairgrounds Entrance
The entrance to the annual fair, it's a much larger than you remembered it. The food stands are to the north. The fair games are to the west. The rides are to the east. The parking lot lies south.

You can see Balloon Cart (empty) here.

>w
Fair Games
The games bring back memories of visiting the fair as a young tot. The barrel roll used to be your favorite. The fairgrounds entrance lies to the east. The bingo tent lies to the north. 

You can see Barrel (closed) here.

>n
Bingo Tent
You return to the tent in which you lost a fair share of money. It's your favorite spot of the entire fair, so much so that the volunteers recognize you. The fair games are south.

You can see Table (on which is Bingo Card) here.

>x table
The same plastic tables they've been using for years. They look more disgusting each time you see them. Maybe they'll buy new tables for the next fair.

>x bingo card
You see an abandoned bingo card lying on the table. You take a quick glance around the tent to see if the card's owner is near. You don't see anyone near this card. Do you play?  The numbers haunt you in your sleep.

>x card
Against your better judgement, you decide to play the abandoned card. After all, it's free to you. Lucky for you, the new round just started.  You can't be trusted at the bingo tent.

>x card
The bingo caller starts rattling off numbers. To your surprise, all of the numbers called are on your card.  So much money spent at the tent.

>x card
As more numbers are called, you start to sweat in anticipation of winning. You're only one number from bingo. It's a race to the finish between yourself and the old broads that stalk the tent.  The numbers haunt you in your sleep.

>x card
The caller shouts the next number, one that isn't on your card. To your horror, one of the broads shouts "BINGO!" at the top of her shriveled lungs. Your head smacks the table as you slouch forward in defeat.  Maybe you should try a different game at the fair.

>x card
You can't be trusted at the bingo tent.

* * *

>open car
It seems to be locked.

>unlock car with hatchback keys
You unlock Car.

>i
You are carrying:
  Hatchback Keys

>l
Parking Lot
 The parking lot is less busy than it was when you arrived; you've been here for hours. The entrance to the fair grounds lies to the north. The exit to the parking lot lies south.

You can see Car (closed) here.

>discard
(Hatchback Keys)
Dropped.

>take hatchback keys
Taken.

>s
You want to leave without your spuddies? That's reckless abandonment, friend.